#######
#>..~.#
#.~^~~#
#.<X>.#
#~~v~.#
#p~..^#
#######