#######
#.-~-p#
#-~v~-#
#.>X<~#
#-~^~-#
#.-.-.#
#######