#######
#.-~-.#
#-~v~-#
#.>X<~#
#-~^~-#
#p-.-.#
#######