######
#p*.*#
#*.*.#
#.*.*#
#*.*X#
######