##########
#~X>>..<<#
#.~~~*..v#
#-~~~*v..#
#-~~~*...#
#.***^#
#-.v.#
#-...#
#.<<.#