##########
#~X>>..<<#
#.~~~*..v#
#-~~~*v..#
#-~~~*...#
#.***^####
#-.v..#
#-....#
#.<<.p#
#######