##########
#~X>>..<<#
#p~~~*..v#
#-~~~*v..#
#-~~~*...#
#.***^####
#-.v..#
#-....#
#.<<..#
#######