##########
#~~~~~~~~#
#~-^-^-X~#
#~<-^-^-~#
#~-<->->~#	
#~<-v->-~#
#~pv-v->~#
#~~~~~~~~#
##########