######
#...X#
#v~~v#
#.~~.#
#p...#
######