######################        
############X#########
#########~*~*~*~######
########*~*~*~*~*#####
#######*~*~*~***~*#### 
##############-#######
######.---------v#####
######.v----<....#####
######.>.~~~-~~~~#####
#########~~^.~~~######
############p#########
######################