#########
#p-v>...#
#v-.vvvv#
#>--.***#
#.-.<~~~#
#>-----~#
#>-----.#
#*******#
#~~~~~~-#
#X~~~~~-#
#^-....<#
#########