#########
#p--.~v~#
#-~~~~.~#
#.~..~.v#
#~~*~~~.#
#..*~X~.#
#~~~~*~~#
#.**~*~.#
#########