################
#pv-v~~~~~~~~~~#
#.~~-~~~~~~~~~~#
#~~~.-v-------v#
#---<----------#
#.***v--------<#
#-###----------#
#>-.#.~~~~~~~~~#
#####>--------~#
#---->vvvvvvvvv#
#----v---------#
#------.-------#
#-----#~~~~~~~~#
#-.-->-.------v#
#*^*~.###-----X#
################