#########
#~~~~~~~#
#~p^>-v~#
#~<.*-.~#
#~--*<-~#
#~-*X*-~#
#~>.-.<~#
#~~~~~~~#
#########