#########
#p~.*~**#
#~~~~~~~#
#*~*.~.v#
#.~*~*!.#
#~~~.*~~#
#.~*~~~.#
#.~>*~.X#
#########