#######
#p.~.v#
#.~~~.#
#.~~~~#
#>~-v-#
#....X#
#######