######
#p**.#
#***.#
#***.#
#...X#
######

