#######
#~~~~~#
#~<.X~#
#~-~~~#
#~.~~~#
#~^.p~#
#~~~~~#
#######