######
#p^>X#
#>v>^#
#v..v#
#<><>#
######